--------------------------------------------------------------------------------
--p-----------------------------------------------------------------------------
--X-----------------------------------------------------------------------------
---X----D-----------------------------------------------------------------------
----XXX-------------------------------------------------------------------------
-------XXX-----------------------------------D----------------------------------
----------XX-X--X--X------------------------------------------------------------
-------------X--X--X-----------------------XXXX---------------XXXX--X-----------
-------------X--X--X----------------------X----X--X--X-X-----X------------------
-------------X--X--X-------------------XXX------------------X-------------------
-------------X------------------------X--------------------X--------------------
-------------X-----------------------X--------------------X---------------------
-------------XXXXXXX-----v-----v----X--------------------X----------------------
-------------------XXXXXXXXX-XXXXXXX----------XXXXXXXXXXX-----------------------
--------------------------------------------------------------------------------
--------------------------------------------------------------------------------
--------------------------------------------------------------------------------
-------------------------XXXXX--------------------------------------------------
--------------------------------------------------------------------------------
---------------------------XXXXXXX----------------------------------------------
--------------------------------------------------------------------------------
--------------------------XXXXX-------------------------------------------------
-----------------------------------------XXXXXXXXXX-----------------------------
---------------------------------------------------X----------------------------
----------------------------------------------------X---------------------------
-----------------------------------------------------X--------------------------
--------------------------------------------------------------------------------
--------------------------------------------------------------------------------
--------------------------------------------------------------------------------
