------------
-p----------
-X----X---X-
--X---------
--XX------X-
--XXXXX---X-
-------XXX--
------------
