--------------------------------------------------------------------------------
--p-----------------------------------------------------------------------------
--------------------------------------------------------------------------------
--------------------------------------------------------------------------------
--------------------------------------------------------------------------------
--XXXXX-XX-----------------------------------D----------------------------------
------X-X-XX-X-----X------------------------------------------------------------
------X-X----X--XX-X-----------------------XXXX---------------XXXX--X-----------
------X-X----X--X--X----------------------X----X--X--X-X-----X------------------
------X-XXXXXX--X--X-------------------XXX------------------X-------------------
------X-------------------------------X--------------------X--------------------
------XXXXXXXX----------------------X--------------------X----------------------
-------------XXXXXXX-----v-----v----X--------------------X----------------------
-------------------XXXXXXXXXXXXXXXXX----------XXXXXXXXXXX-----------------X-----
--------------------------------------------------------------------------------
--------------------------------------------------------------------------------
--------------------------------------------------------------------------------
--------------------------------------------------------------------------------
--------------------------------------------------------------------------------
--------------------------------------------------------------------------------
--------------------------------------------------------------------------------
--------------------------------------------------------------------------------
