--------------------------------------------------------------------------------
--p-----------------------------------------------------------------------------
--------------------------------------------------------------------------------
--------------------------------------------------------------------------------
--------------------------------------------------------------------------------
--XXXXXXXX-----------------------------------D----------------------------------
----------XX-X-----X-----------------------------------------------------------
-------------X--XX-X-----------------------XXXX---------------XXXX--X-----------
-------------X--X--X----------------------X----X--X--X-X-----X------------------
-------------X--X--X-------------------XXX------------------X-------------------
-------------X------------------------X--------------------X--------------------
-------------X-----------------------X--------------------X---------------------
-------------XXXXXXX-----v-----v----X--------------------X----------------------
-------------------XXXXXXXXXXXXXXXXX----------XXXXXXXXXXX-----------------------
--------------------------------------------------------------------------------
--------------------------------------------------------------------------------
--------------------------------------------------------------------------------
--------------------------------------------------------------------------------
--------------------------------------------------------------------------------
--------------------------------------------------------------------------------
--------------------------------------------------------------------------------
--------------------------------------------------------------------------------
